0

_ _ # # # # #
_ _ # _ _ _ #
# # # _ # _ #
# @ o _ _ _ #
# # _ _ o # #
_ # # # _ # _
_ _ _ # # # _

_ _ _ _ _ _ _
_ _ _ _ _ _ _
_ _ _ _ _ _ _
_ _ _ _ _ _ _
_ _ x _ _ _ _
_ _ _ _ x _ _
_ _ _ _ _ _ _

